NO ./textures/north.xpm
SO ./textures/south.xpm
WE ./textures/west.xpm
EA ./textures/east.xpm
F 220,100,0
C 135,206,235

1111111111111
1000000000001
1011110111101
1010000100001
1010111101111
1010000001001
1010111101001
1000000N01001
1111111111111
