NO ./no.xpm
SO ./so.xpm
WE ./we.xpm
F 220,100,0
EA ./ea.xpm
C 30,30,30
11111
10001
10N01
10001
11111

