NO ./no.xpm
SO ./so.xpm
WE ./we.xpm
EA ./ea.xpm	
		F			 220 		100,0
C 30,30,30

11111
