NO ./no.xpm
SO ./so.xpm
WE ./we.xpm
F 220,100,0
111111
EA ./ea.xpm
C 30,30,30
